A1A2A1A3A1A4A3A4A3
A2A1A4A1A3A3A2A1A2
A3A4A2A2A4A2A1A2A1
A4A3A3A4A2A1A4A3A4
A1A2A1A3A1A4A3A4A3
A2A1A4A1A3A3A2A1A2
A3A4A2A2A4A2A1A2A1
A4A3A3A4A2A1A4A3A4
A1A2A1A3A1A4A3A4A3
A2A1A4A1A3A3A2A1A2
A3A4A2A2A4A2A1A2A1
A4A3A3A4A2A1A4A3A4